131,000,000,000,000,000,000,000,000,000,000,000,000,000,000,000,000,000,000,000,000,000,000,000,000,000,000,000,000,000,000,000,000,000,000,000,000,000,000,000,000,000,000,000,000,000,000,000,000,000,000,000,000,000,000,000,000,000,000,000,000,000,000,000,000,000,000,000,000,000,000,000,000,000,000,000,000,000,000,000,000,000,000,000,000,000,000,000,164,164,000,000,000,000,000,000,000,000,000,164,
131,000,000,000,000,000,000,000,000,000,000,000,000,000,000,000,000,000,000,000,000,000,000,000,000,000,000,000,000,000,000,000,000,000,000,000,000,000,000,000,000,000,000,000,000,000,000,000,000,000,000,000,000,000,000,000,000,000,000,000,000,000,000,000,000,000,000,000,000,000,000,000,000,000,000,000,000,000,000,000,000,000,000,000,000,000,000,000,164,000,000,000,000,000,000,150,000,000,000,164,
131,000,000,000,000,000,000,000,000,000,000,000,000,000,000,000,000,000,000,000,000,000,000,000,000,000,000,000,000,000,000,000,000,000,000,000,154,154,154,154,154,154,154,154,154,154,154,154,154,133,000,000,000,000,000,000,000,000,000,000,000,000,000,000,000,000,154,154,154,154,154,154,154,154,154,154,154,133,000,000,000,000,000,154,154,154,154,000,000,000,000,000,154,154,154,154,154,154,154,164,
131,000,000,000,000,000,000,000,000,000,000,000,000,000,000,000,000,000,154,154,000,000,000,000,000,154,154,154,133,000,000,000,000,000,000,154,164,164,164,164,164,164,164,164,164,164,164,164,164,132,133,000,000,000,000,000,000,000,000,000,000,000,000,000,000,154,134,164,164,164,164,164,164,164,164,164,164,131,000,000,000,000,000,000,000,000,000,000,000,000,000,154,134,164,164,164,164,164,164,164,
131,000,000,000,000,000,000,000,000,000,000,000,000,000,000,000,000,000,164,164,000,000,000,000,154,134,164,164,132,154,154,154,000,000,000,000,164,164,164,164,164,164,164,164,164,164,164,164,164,164,132,154,154,154,154,154,000,000,000,000,000,000,000,000,154,134,164,164,164,164,164,164,164,164,164,164,164,131,000,000,000,000,000,000,000,000,000,000,000,000,154,134,164,164,164,164,164,164,164,164,
132,154,154,154,154,154,154,154,154,154,154,154,154,154,133,000,000,000,000,000,000,000,000,154,134,164,164,164,164,164,164,164,000,000,000,000,000,000,000,000,000,000,000,000,000,000,000,000,000,000,000,000,000,000,000,000,000,000,000,000,000,000,000,154,134,164,164,164,164,164,164,164,164,164,164,164,164,131,000,000,000,000,000,000,000,000,000,000,000,154,134,164,164,164,164,164,164,164,164,164,
164,164,164,164,164,164,164,164,164,164,164,164,164,164,132,133,000,000,000,000,000,000,154,134,164,164,164,164,164,164,164,164,000,000,000,000,000,000,000,000,000,000,000,000,000,000,000,000,000,000,000,000,000,000,000,000,000,000,000,000,000,000,154,134,164,164,164,164,164,164,164,164,164,164,164,164,164,132,133,000,000,000,000,000,000,000,000,000,154,134,164,164,164,164,164,164,164,164,164,164,
164,164,164,164,164,164,164,164,164,164,164,164,164,164,164,132,154,154,154,154,154,154,134,164,164,164,164,164,164,164,164,164,154,154,154,154,154,154,154,154,154,154,154,154,154,154,154,154,154,154,154,154,154,154,154,154,154,154,154,154,154,154,134,164,164,164,164,164,164,164,164,164,164,164,164,164,164,164,132,154,154,154,154,154,154,154,154,154,134,164,164,164,164,164,164,164,164,164,164,164,
164,164,164,164,164,164,164,164,164,164,164,164,164,164,164,164,164,164,164,164,164,164,164,164,164,164,164,164,164,164,164,164,164,164,164,164,164,164,164,164,164,164,164,164,164,164,164,164,164,164,164,164,164,164,164,164,164,164,164,164,164,164,164,164,164,164,164,164,164,164,164,164,164,164,164,164,164,164,164,164,164,164,164,164,164,164,164,164,164,164,164,164,164,164,164,164,164,164,164,164
